#module 0 size: 18 bs: 9.89377e-102
7 10 13 17 18 22 28 31 33 37 38 41 44 45 47 50 51 56 
#module 1 size: 28 bs: 7.01592e-14
1 2 3 4 9 15 21 23 27 30 34 43 46 48 49 53 60 63 68 70 72 73 74 78 79 81 83 93 
#module 2 size: 35 bs: 0.000478335
5 11 16 25 32 35 36 40 57 61 62 64 69 75 76 77 80 82 84 85 86 87 88 89 90 91 92 93 94 95 96 97 98 99 100 
#module 3 size: 15 bs: 9.97458e-14
6 19 20 29 42 52 54 55 58 59 65 66 67 71 97 
#module 4 size: 13 bs: 0.00988883
124 135 145 154 161 167 179 182 184 185 187 188 200 
#module 5 size: 47 bs: 0.00230795
102 107 111 112 117 119 120 125 126 127 128 130 132 133 134 137 138 150 152 153 156 157 158 162 165 168 169 170 171 172 174 177 180 181 186 189 190 191 192 193 194 195 196 197 198 199 200 
#module 6 size: 26 bs: 9.07712e-09
103 106 114 116 121 123 136 139 140 141 142 143 144 146 147 148 149 151 155 159 160 166 171 175 176 183 
#module 7 size: 100 bs: 9.92068e-101
201 202 203 204 205 206 207 208 209 210 211 212 213 214 215 216 217 218 219 220 221 222 223 224 225 226 227 228 229 230 231 232 233 234 235 236 237 238 239 240 241 242 243 244 245 246 247 248 249 250 251 252 253 254 255 256 257 258 259 260 261 262 263 264 265 266 267 268 269 270 271 272 273 274 275 276 277 278 279 280 281 282 283 284 285 286 287 288 289 290 291 292 293 294 295 296 297 298 299 300 
#module 0 size: 18 bs: 8.98475e-101
7 10 13 17 18 22 28 31 33 37 38 41 44 45 47 50 51 56 
#module 1 size: 28 bs: 7.01592e-14
1 2 3 4 9 15 21 23 27 30 34 43 46 48 49 53 60 63 68 70 72 73 74 78 79 81 83 93 
#module 2 size: 35 bs: 0.000478336
5 11 16 25 32 35 36 40 57 61 62 64 69 75 76 77 80 82 84 85 86 87 88 89 90 91 92 93 94 95 96 97 98 99 100 
#module 3 size: 15 bs: 9.97458e-14
6 19 20 29 42 52 54 55 58 59 65 66 67 71 97 
#module 4 size: 51 bs: 0.0025921
201 203 206 208 210 212 216 217 218 222 223 224 225 226 230 232 234 237 239 240 244 245 247 248 249 253 254 256 259 262 263 264 265 266 267 270 272 274 276 277 282 284 285 286 288 289 291 294 295 296 297 
#module 5 size: 12 bs: 1.3657e-05
214 215 252 275 278 281 287 290 293 298 299 300 
#module 6 size: 13 bs: 0.0785252
124 135 145 154 161 167 179 182 184 185 187 188 200 
#module 7 size: 47 bs: 0.0109653
102 107 111 112 117 119 120 125 126 127 128 130 132 133 134 137 138 150 152 153 156 157 158 162 165 168 169 170 171 172 174 177 180 181 186 189 190 191 192 193 194 195 196 197 198 199 200 
#module 8 size: 26 bs: 9.07712e-09
103 106 114 116 121 123 136 139 140 141 142 143 144 146 147 148 149 151 155 159 160 166 171 175 176 183 
#module 0 size: 61 bs: 0.000374533
201 203 204 205 206 208 210 211 212 213 216 217 218 219 222 223 224 225 226 227 229 230 232 234 237 239 240 242 243 244 245 247 248 249 253 254 256 259 262 263 264 265 266 267 270 272 274 276 277 282 284 285 286 288 289 291 294 295 296 297 299 
#module 1 size: 41 bs: 0.000296795
202 205 207 209 214 215 220 221 228 231 233 235 236 238 241 246 250 251 252 255 257 258 260 261 268 269 271 273 275 278 279 280 281 283 287 290 292 293 298 299 300 
#module 2 size: 18 bs: 5.63785e-18
7 10 13 17 18 22 28 31 33 37 38 41 44 45 47 50 51 56 
#module 3 size: 28 bs: 7.01592e-14
1 2 3 4 9 15 21 23 27 30 34 43 46 48 49 53 60 63 68 70 72 73 74 78 79 81 83 93 
#module 4 size: 25 bs: 2.03613e-15
103 106 114 116 121 123 136 139 140 141 142 143 144 146 147 148 149 151 155 159 160 166 175 176 183 
#module 5 size: 46 bs: 1.23004e-13
102 107 111 112 117 119 120 125 126 127 128 130 132 133 134 137 138 150 152 153 156 157 158 162 165 168 169 170 172 174 177 180 181 186 189 190 191 192 193 194 195 196 197 198 199 200 
#module 6 size: 29 bs: 3.32368e-06
101 104 105 108 109 110 113 115 118 122 124 129 131 135 145 154 161 163 164 167 173 178 179 182 184 185 187 188 200 
#module 7 size: 34 bs: 1.97066e-12
5 11 16 25 32 35 36 40 57 61 62 64 69 75 76 77 80 82 84 85 86 87 88 89 90 91 92 94 95 96 97 98 99 100 
#module 8 size: 21 bs: 0.000126673
6 8 12 14 19 20 24 26 29 39 42 52 54 55 58 59 65 66 67 71 97 
#module 0 size: 61 bs: 0.000374533
201 203 204 205 206 208 210 211 212 213 216 217 218 219 222 223 224 225 226 227 229 230 232 234 237 239 240 242 243 244 245 247 248 249 253 254 256 259 262 263 264 265 266 267 270 272 274 276 277 282 284 285 286 288 289 291 294 295 296 297 299 
#module 1 size: 41 bs: 0.000296796
202 205 207 209 214 215 220 221 228 231 233 235 236 238 241 246 250 251 252 255 257 258 260 261 268 269 271 273 275 278 279 280 281 283 287 290 292 293 298 299 300 
#module 2 size: 18 bs: 5.63785e-18
7 10 13 17 18 22 28 31 33 37 38 41 44 45 47 50 51 56 
#module 3 size: 28 bs: 7.01592e-14
1 2 3 4 9 15 21 23 27 30 34 43 46 48 49 53 60 63 68 70 72 73 74 78 79 81 83 93 
#module 4 size: 25 bs: 2.03613e-15
103 106 114 116 121 123 136 139 140 141 142 143 144 146 147 148 149 151 155 159 160 166 175 176 183 
#module 5 size: 46 bs: 2.34927e-14
102 107 111 112 117 119 120 125 126 127 128 130 132 133 134 137 138 150 152 153 156 157 158 162 165 168 169 170 172 174 177 180 181 186 189 190 191 192 193 194 195 196 197 198 199 200 
#module 6 size: 29 bs: 3.32368e-06
101 104 105 108 109 110 113 115 118 122 124 129 131 135 145 154 161 163 164 167 173 178 179 182 184 185 187 188 200 
#module 7 size: 34 bs: 1.97066e-12
5 11 16 25 32 35 36 40 57 61 62 64 69 75 76 77 80 82 84 85 86 87 88 89 90 91 92 94 95 96 97 98 99 100 
#module 8 size: 21 bs: 0.000126673
6 8 12 14 19 20 24 26 29 39 42 52 54 55 58 59 65 66 67 71 97 
#module 0 size: 61 bs: 0.000374533
201 203 204 205 206 208 210 211 212 213 216 217 218 219 222 223 224 225 226 227 229 230 232 234 237 239 240 242 243 244 245 247 248 249 253 254 256 259 262 263 264 265 266 267 270 272 274 276 277 282 284 285 286 288 289 291 294 295 296 297 299 
#module 1 size: 41 bs: 0.000296796
202 205 207 209 214 215 220 221 228 231 233 235 236 238 241 246 250 251 252 255 257 258 260 261 268 269 271 273 275 278 279 280 281 283 287 290 292 293 298 299 300 
#module 2 size: 18 bs: 5.63785e-18
7 10 13 17 18 22 28 31 33 37 38 41 44 45 47 50 51 56 
#module 3 size: 28 bs: 7.01592e-14
1 2 3 4 9 15 21 23 27 30 34 43 46 48 49 53 60 63 68 70 72 73 74 78 79 81 83 93 
#module 4 size: 29 bs: 3.32368e-06
101 104 105 108 109 110 113 115 118 122 124 129 131 135 145 154 161 163 164 167 173 178 179 182 184 185 187 188 200 
#module 5 size: 34 bs: 1.97066e-12
5 11 16 25 32 35 36 40 57 61 62 64 69 75 76 77 80 82 84 85 86 87 88 89 90 91 92 94 95 96 97 98 99 100 
#module 6 size: 21 bs: 0.000126673
6 8 12 14 19 20 24 26 29 39 42 52 54 55 58 59 65 66 67 71 97 
#module 7 size: 26 bs: 1.37211e-11
103 106 114 116 121 123 136 139 140 141 142 143 144 146 147 148 149 151 155 159 160 166 171 175 176 183 
#module 8 size: 46 bs: 1.23004e-13
102 107 111 112 117 119 120 125 126 127 128 130 132 133 134 137 138 150 152 153 156 157 158 162 165 168 169 170 172 174 177 180 181 186 189 190 191 192 193 194 195 196 197 198 199 200 
#module 0 size: 18 bs: 5.63785e-18
7 10 13 17 18 22 28 31 33 37 38 41 44 45 47 50 51 56 
#module 1 size: 28 bs: 7.01591e-14
1 2 3 4 9 15 21 23 27 30 34 43 46 48 49 53 60 63 68 70 72 73 74 78 79 81 83 93 
#module 2 size: 21 bs: 0.000126673
6 8 12 14 19 20 24 26 29 39 42 52 54 55 58 59 65 66 67 71 97 
#module 3 size: 35 bs: 9.97458e-14
5 11 16 25 32 35 36 40 57 61 62 64 69 75 76 77 80 82 84 85 86 87 88 89 90 91 92 93 94 95 96 97 98 99 100 
#module 4 size: 29 bs: 3.32368e-06
101 104 105 108 109 110 113 115 118 122 124 129 131 135 145 154 161 163 164 167 173 178 179 182 184 185 187 188 200 
#module 5 size: 41 bs: 3.32497e-07
202 207 209 214 215 220 221 228 231 233 235 236 238 240 241 246 250 251 252 255 257 258 260 261 268 269 271 273 275 278 279 280 281 283 287 290 292 293 298 299 300 
#module 6 size: 60 bs: 1.2634e-08
201 203 204 206 208 210 211 212 213 216 217 218 219 222 223 224 225 226 227 229 230 232 234 237 239 240 242 243 244 245 247 248 249 253 254 256 259 262 263 264 265 266 267 270 272 274 276 277 282 284 285 286 288 289 291 294 295 296 297 299 
#module 7 size: 26 bs: 1.37211e-11
103 106 114 116 121 123 136 139 140 141 142 143 144 146 147 148 149 151 155 159 160 166 171 175 176 183 
#module 8 size: 48 bs: 4.18575e-06
102 107 111 112 117 119 120 125 126 127 128 130 132 133 134 135 137 138 150 152 153 156 157 158 162 165 168 169 170 171 172 174 177 180 181 186 189 190 191 192 193 194 195 196 197 198 199 200 
#module 0 size: 18 bs: 5.63785e-18
7 10 13 17 18 22 28 31 33 37 38 41 44 45 47 50 51 56 
#module 1 size: 28 bs: 7.01592e-14
1 2 3 4 9 15 21 23 27 30 34 43 46 48 49 53 60 63 68 70 72 73 74 78 79 81 83 93 
#module 2 size: 25 bs: 0.0601442
103 106 114 116 121 123 136 139 140 141 142 143 144 146 147 148 149 151 155 159 160 166 175 176 183 
#module 3 size: 21 bs: 0.000126673
6 8 12 14 19 20 24 26 29 39 42 52 54 55 58 59 65 66 67 71 97 
#module 4 size: 35 bs: 9.97458e-14
5 11 16 25 32 35 36 40 57 61 62 64 69 75 76 77 80 82 84 85 86 87 88 89 90 91 92 93 94 95 96 97 98 99 100 
#module 5 size: 29 bs: 3.32368e-06
101 104 105 108 109 110 113 115 118 122 124 129 131 135 145 154 161 163 164 167 173 178 179 182 184 185 187 188 200 
#module 6 size: 48 bs: 4.18574e-06
102 107 111 112 117 119 120 125 126 127 128 130 132 133 134 135 137 138 150 152 153 156 157 158 162 165 168 169 170 171 172 174 177 180 181 186 189 190 191 192 193 194 195 196 197 198 199 200 
#module 7 size: 60 bs: 1.2634e-08
201 203 204 206 208 210 211 212 213 216 217 218 219 222 223 224 225 226 227 229 230 232 234 237 239 240 242 243 244 245 247 248 249 253 254 256 259 262 263 264 265 266 267 270 272 274 276 277 282 284 285 286 288 289 291 294 295 296 297 299 
#module 8 size: 41 bs: 3.32497e-07
202 207 209 214 215 220 221 228 231 233 235 236 238 240 241 246 250 251 252 255 257 258 260 261 268 269 271 273 275 278 279 280 281 283 287 290 292 293 298 299 300 
#module 0 size: 18 bs: 5.63785e-18
7 10 13 17 18 22 28 31 33 37 38 41 44 45 47 50 51 56 
#module 1 size: 42 bs: 0.000315986
202 205 207 209 214 215 220 221 228 231 233 235 236 238 240 241 246 250 251 252 255 257 258 260 261 268 269 271 273 275 278 279 280 281 283 287 290 292 293 298 299 300 
#module 2 size: 60 bs: 1.26339e-08
201 203 204 206 208 210 211 212 213 216 217 218 219 222 223 224 225 226 227 229 230 232 234 237 239 240 242 243 244 245 247 248 249 253 254 256 259 262 263 264 265 266 267 270 272 274 276 277 282 284 285 286 288 289 291 294 295 296 297 299 
#module 3 size: 28 bs: 7.01592e-14
1 2 3 4 9 15 21 23 27 30 34 43 46 48 49 53 60 63 68 70 72 73 74 78 79 81 83 93 
#module 4 size: 21 bs: 0.000126673
6 8 12 14 19 20 24 26 29 39 42 52 54 55 58 59 65 66 67 71 97 
#module 5 size: 34 bs: 1.97066e-12
5 11 16 25 32 35 36 40 57 61 62 64 69 75 76 77 80 82 84 85 86 87 88 89 90 91 92 94 95 96 97 98 99 100 
#module 6 size: 29 bs: 3.32368e-06
101 104 105 108 109 110 113 115 118 122 124 129 131 135 145 154 161 163 164 167 173 178 179 182 184 185 187 188 200 
#module 7 size: 26 bs: 1.37211e-11
103 106 114 116 121 123 136 139 140 141 142 143 144 146 147 148 149 151 155 159 160 166 171 175 176 183 
#module 8 size: 46 bs: 1.23004e-13
102 107 111 112 117 119 120 125 126 127 128 130 132 133 134 137 138 150 152 153 156 157 158 162 165 168 169 170 172 174 177 180 181 186 189 190 191 192 193 194 195 196 197 198 199 200 
